DDDWDDDDDD
DWDDDDDWWD
DDDWDDDDDD
DDDDDDDDDD
WDDDWWDDDW
WDDDDDDDDW
DWWDDDDDDD
DDDDDWDDWD
DDDDDWDDDW
DDWDDWDDWW